0 96 86 11 87 19 84 49 89 20 20 92 80 97 12 44 26 77 69 14 31 68 84 82 27 92 71 
39 0 22 11 85 27 27 94 15 51 66 48 38 16 75 25 99 51 52 39 55 15 12 85 45 14 77 
56 46 0 61 21 13 85 96 49 55 36 87 35 94 74 86 92 61 78 78 48 62 40 15 69 42 39 
88 46 65 0 36 37 66 81 50 72 57 55 39 62 64 42 68 29 90 21 26 59 66 69 24 51 17 
68 66 25 25 0 41 92 79 74 97 60 84 28 99 31 55 53 11 38 46 32 25 23 15 95 20 25 
57 26 81 32 77 0 51 86 30 99 24 34 57 26 64 61 88 68 83 84 10 92 91 71 15 64 41 
78 29 93 54 61 31 0 15 25 44 62 94 74 83 43 43 78 32 41 29 54 22 83 72 37 56 33 
20 19 34 67 56 75 68 0 46 73 67 37 55 64 13 52 10 29 99 95 95 10 51 68 23 68 40 
87 20 29 96 58 66 99 37 0 21 96 92 78 16 28 15 46 70 77 51 78 77 25 12 21 63 74 
43 61 33 69 52 20 99 25 89 0 58 27 77 19 72 56 36 93 57 19 52 92 76 89 64 81 91 
73 91 63 71 17 17 43 84 32 47 0 14 52 53 82 79 91 40 57 29 94 68 79 32 50 33 56 
12 20 82 67 73 69 89 62 48 18 62 0 28 51 19 44 35 49 18 31 51 13 37 73 10 46 41 
45 88 32 95 69 23 47 61 15 32 12 66 0 75 46 63 91 43 71 38 22 16 19 60 43 39 23 
29 83 53 75 47 81 31 41 34 11 39 54 50 0 49 81 91 14 21 32 84 44 86 88 22 94 12 
73 34 35 35 38 90 65 56 95 65 18 40 85 31 0 45 43 21 62 62 90 31 89 41 26 14 48 
20 56 79 43 96 40 81 45 18 97 16 99 74 50 89 0 94 55 25 82 74 37 11 48 10 74 36 
61 14 81 84 93 19 30 90 79 19 77 61 70 79 60 49 0 22 48 37 23 89 22 11 37 43 26 
44 41 21 19 17 78 69 70 80 77 65 35 14 97 78 84 71 0 80 27 95 56 13 24 88 89 10 
73 61 48 48 13 53 50 77 75 90 79 70 12 99 93 10 99 84 0 85 88 43 41 45 14 52 31 
20 49 70 40 27 33 31 16 15 17 32 41 74 21 85 38 31 88 15 0 11 77 28 11 56 14 40 
12 10 67 42 26 43 97 82 43 10 16 45 73 55 48 96 94 85 79 68 0 19 74 13 15 19 57 
100 50 55 92 47 24 35 87 31 30 50 73 92 89 44 93 78 84 31 87 25 0 60 63 82 35 27 
78 47 31 38 98 61 33 69 44 56 36 52 64 93 19 86 34 28 56 30 93 90 0 33 27 97 29 
84 32 41 50 88 73 66 30 47 89 66 93 33 89 50 33 55 88 66 36 30 39 78 0 39 36 45 
35 14 34 88 23 13 42 79 78 10 37 95 69 64 86 43 56 30 30 41 95 67 80 70 0 45 46 
62 71 99 55 55 11 23 53 48 62 96 59 76 63 60 55 21 50 96 61 29 12 50 88 84 0 57 
19 95 50 68 34 65 53 78 51 72 80 33 56 35 81 25 26 34 48 97 55 68 81 50 56 40 0 